carlos
==================
|                |
|                |
|                |
|         *      |
|                |
|                |
|                |
|                |
|                |
==================
